8,8,
#      #
#B# ##  
#####   
##### # 
#       
# ######
#       
# # # #A